#O##################
# ## #   # #  #  ###
#      ## # ##  #  #
## ### ########  ###
####   ##  #  ##  ##
####      #   # ## #
### ####   # ### ###
### ## ##     # ####
#   #   ##  ####   #
#  # # ####   ######
##   ##  ###   #####
# # # ####       # #
###  #  # ## ###   #
# ###    #  #   ## #
##################X#
