#O##################
#  #         #   # #
#     ## #### #  # #
##   #    ####   # #
##    # # ##  #### #
###     ### # #  # #
## #     #####  ####
## #    ## #      ##
## # ##  #### # # ##
##  ####        # ##
### # ## #  ## ## ##
#  ### #  ## #   # #
##### ## #     #   #
##    #  ## ##  #  #
##################X#
