#O#######
#       #
# ## # ##
# #     #
# # # # #
# # # # #
# # # ###
#       #
#########