#O#########
#    #    #
# ####  ###
# #       #
# # ### ###
#   # #   #
# ### ### # 
#      #  #
########X##
