################O###
##    ## ##      # #
# #     ##    ######
# # #####  # # ### #
## #    ## # ## # ##
#   #  #    ## #  ##
###     #   ##   # #
##   # # #    ######
### ##  # ## ## ####
#  ### ###   #### ##
#   #    ## #      #
######    # #  #  ##
#    # #### # # # ##
#  # # ####     ## #
###########X########
