#O################
#     #         ##
# # ### #######  #
# #         ##   #
# ###### #########
#         ## #   #
# #######  ## # ##
###            # #
# ## #########  ##
#          #    #
### ########### ##
#            #  ##
# ######## #######
#     #          #
# #############  #
################X#
